# Approximate phoneme mappings from NLTK Unicode table to McGill
# ProsodyLab French phoneset for force alignment of East Cree (note
# that the Unicode table has Inuktitut phonemes in it, we map those to
# Cree phonemes here too)
# Cree phones in "dictionary" order are at the top, others below
aI	E
i	i
i:	i i
u	u
u:	u u
A	a
A:	a a
p	p
pw	p w
t	t
tw	t w
k	k
kw	k w
G	t S
Gw	t S w
m	m
mw	m w
n	n
nw	n w
l	l
lw	l w
s	s
sw	s w
S	S
Sw	S w
j	j
jw	j w
h	s
w	w
?	k
# Not Cree sounds but we might encounter them
r	R
rw	R w
v	v
vw	v w
cw	t s w
d	d
Dw	z w
D	z
dz	d z
e:	e
e	E
eh	E s
Gh	t S s
hl	h l
hw	s w
ih	i s
kh	k s
mh	m s
N	G
nh	n h
oh	O s
o:	o
o	O
q	k
th	t s
tj	t j
ts	t s
z	z
